10 10 10 10 10 10 10 10 10 10 10 10
10 0 0 0 0 0 0 0 0 0 0 10
10 0 10 10 10 10 10 10 10 10 0 10
10 0 10 0 0 0 0 0 0 10 0 10
10 0 10 0 10 10 10 10 0 10 0 10
10 0 10 0 10 00 0 10 0 10 0 10
10 0 10 0 10 100 0 10 0 10 0 10
10 0 10 0 10 10 0 10 0 10 0 10
10 0 10 0 0 0 0 10 0 10 0 10
10 0 10 10 10 10 10 10 0 10 0 10
10 0 0 0 0 0 0 0 0 10 0 10
10 10 10 10 10 10 10 10 10 10 0 10
1000 1000 1000 1000 1000 1000 1000 1000 1000 1000 1000 1000
0 0 0 0 0 0 0 0 0 0 0 0