15 false
10 10 10 10 10 10 10 10 10 10 10 10
10 0 0 0 0 0 0 0 0 0 0 10
10 0 10 10 10 10 10 10 10 10 0 10
10 0 10 0 0 0 0 0 0 10 0 10
10 0 10 0 10 10 10 10 0 10 0 10
10 0 10 0 10 00 0 10 0 10 0 10
10 0 10 0 10 100 0 10 0 10 0 10
10 0 10 0 10 10 0 10 0 10 0 10
10 0 10 0 0 0 0 10 0 10 0 10
10 0 10 10 10 10 10 10 0 10 0 10
10 0 0 0 0 0 0 0 0 10 0 10
10 10 10 10 10 10 10 10 10 10 0 10
0 0 0 0 0 0 0 0 0 0 0 0
0 0 0 0 0 0 0 0 0 0 0 0