10
false
10 10 10 10 10 10 10 10 10 10 10 10
10 0 0 0 0 0 0 0 0 0 0 10
10 0 10 10 10 10 10 10 10 10 0 10
10 0 10 0 0 0 0 0 0 10 0 10
10 0 10 0 10 10 10 10 0 10 0 10
10 0 10 0 10 00 0 10 0 10 0 10
10 0 10 0 10 50 0 10 0 10 0 10
10 0 10 0 10 10 0 10 0 10 0 10
15 0 15 0 0 0 0 15 0 15 0 15
20 0 20 20 20 20 20 20 0 20 0 20
25 0 0 0 0 0 0 0 0 25 0 25
30 30 30 30 30 30 30 30 30 30 0 30
0 0 0 0 0 0 0 0 0 0 0 0
0 0 0 0 0 0 0 0 0 0 0 0