35
true
120 120   0   0   0   0   0   0   0   0 120 120
120   0   0   0   0   0   0   0   0   0   0 120
  0   0  20  40   0   0   0   0  40  20   0   0
  0   0  20  40  70   0   0  70  40  20   0   0
  0   0   0  70  90  90  90  90  70   0   0   0
  0   0   0  90  90  90  90  90  90   0   0   0
  0   0   0   0  90  90  90  90   0   0   0   0
  0   0   0   0  70  40  40  70   0   0   0   0
  0   0   0  40  20  20  20  20  40   0   0   0
  0   0   0  20   0   0   0   0  20   0   0   0
  0   0   0   0   0   0   0   0   0   0   0   0
 40  40   0   0   0   0   0   0   0   0  40  40
  0   0   0   0   0   0   0   0   0   0   0   0
  0   0   0   0   0   0   0   0   0   0   0   0