30
true
130 130   0   0   0   0   0   0   0   0  130 130
130   0  10   0   0   0   0   0   0  10    0 130
  0  10  30  50   0   0   0   0  50  30   10   0
  0   0  30  50  80   0   0  80  50  30    0   0
  0   0   0  80 100 100 100 100  80   0    0   0
  0   0   0 100 100 100 100 100 100   0    0   0
  0   0   0   0 100 100 100 100   0   0    0   0
  0   0   0   0  80  50  50  80   0   0    0   0
  0   0   0  50  30  30  30  30  50   0    0   0
  0   0  10  30  10   0   0  10  30  10    0   0
  0   0  10   0   0   0   0   0   0  10    0   0
 50  50   0   0   0   0   0   0   0   0   50  50
  0   0   0   0   0   0   0   0   0   0    0   0
  0   0   0   0   0   0   0   0   0   0    0   0