25
true
150 150 0   0   0   0   0   0   0   0   150 150
150 10  30  0   0   0   0   0   0   30  10  150
0   30  50  70  0   0   0   0   70  50  30  0
0   0   50  70  100 0   0   100 70  50  0   0
0   0   0   100 120 120 120 120 100 0   0   0
0   0   0   120 150 150 150 150 120 0   0   0
0   0   0   0   120 120 120 120 0   0   0   0
0   0   0   0   100 70  70  100 0   0   0   0
0   0   0   70  50  50  50  50  70  0   0   0
0   0   30  50  30  10  10  30  50  30  0   0
0   10  30  10  0   0   0   0   10  30  10  0
150 150 0   0   0   0   0   0   0   0   150 150
0 0 0 0 0 0 0 0 0 0 0 0
0 0 0 0 0 0 0 0 0 0 0 0