20
true
0 0 75 85 0 0 0 65 45 0 0 0
0 0 0 0 0 0 0 0 0 0 0 0
50 0 55 0 85 50 0 70 60 35 0 40
0 0 0 0 0 0 0 0 0 0 0 0
0 60 70 0 0 50 0 50 0 0 40 75
0 40 35 0 0 0 0 40 0 0 30 15
70 0 0 75 60 75 80 55 60 0 60 0
0 0 0 0 0 0 0 0 0 0 0 0
50 65 0 80 0 0 0 0 60 0 75 55
0 0 0 0 0 0 0 0 0 0 0 0
0 0 80 0 60 0 0 75 0 80 0 0
0 0 0 20 0 0 0 0 15 0 0 0
15 0 0 0 0 20 35 0 15 0 0 15
0 0 0 0 0 0 0 0 0 0 0 0