30
true
0   36   0   0   66   0   0   0   33   0   71   56
0   0   0   0   0   24   0   26   0   15   0   0
0   50   0   15   0   0   0   47   0   0   20   0
0   0   0   0   0   0   0   0   0   0   0   0
0   21   49   0   100 90 80 70 0   51   0   0
0   0   0   0   10 120 120 60 0   0   9   0
0   27   0   0   20 30 40 50 0   54   0   62
0   0   0   0   0   0   0   22   0   0   0   0
0   0   12   0   0   0   0   0   0   0   15   0
0   18   0   0   0   14   0   0   17   0   0   0
0   0   0   25   0   0   0   0   0  10   0   0
12  0   32   0   0   0   12   0   0   0   0   25
0 0 0 0 0 0 0 0 0 0 0 0
0 0 0 0 0 0 0 0 0 0 0 0